1 1 1 1 1 1 1 1 1 1 1 1 1 1 1 1 1 1 1 1 
1 y 0 X 0 0 0 0 0 0 0 0 0 0 0 0 0 1 x 1 
1 1 1 1 1 0 0 0 0 0 0 0 0 0 0 0 0 1 0 1 
1 1 1 0 0 0 0 0 0 0 0 0 0 0 0 0 0 0 0 1 
1 1 1 0 0 0 0 0 0 0 0 0 0 0 0 0 0 0 0 1 
1 0 0 0 0 0 0 0 0 1 1 1 1 1 1 0 0 1 0 1 
1 B 0 0 0 0 P 0 0 0 0 0 0 0 1 0 0 1 0 1 
1 0 0 0 0 0 0 0 0 0 0 0 0 0 1 0 0 1 0 1 
1 1 1 1 0 0 0 0 0 0 0 0 0 0 0 0 0 1 Y 1 
1 1 1 0 0 0 0 0 0 0 0 0 0 0 0 0 0 1 0 1 
1 1 K 0 0 0 0 0 0 0 0 0 0 0 0 0 0 1 D 1 
1 1 1 1 1 1 1 1 1 1 1 1 1 1 1 1 1 1 1 1