1 1 1 1 1 1 1 1 1 1 1 1 1 1 1 1 1 1 1 1 
1 B 0 0 0 0 0 0 0 0 0 0 0 0 0 0 0 0 0 1 
1 1 1 1 1 0 0 0 0 0 0 0 0 0 0 0 0 0 0 1 
1 1 1 0 0 0 0 0 0 0 0 0 0 0 0 0 0 0 0 1 
1 1 1 0 0 0 0 0 0 0 0 0 0 0 0 0 0 0 0 1 
1 0 0 0 0 0 0 0 0 1 1 0 0 1 1 0 0 1 0 1 
1 B 0 0 0 0 P 0 0 1 1 C 0 1 1 0 0 1 K 1 
1 0 0 0 0 0 0 0 0 1 1 1 1 1 1 0 0 1 1 1 
1 1 1 1 0 0 0 0 0 0 0 0 0 0 0 0 0 0 0 1 
1 1 1 0 0 0 0 0 0 0 0 0 0 0 0 0 0 1 0 1 
1 1 B 0 0 0 0 0 0 0 0 0 0 0 0 0 0 1 D 1 
1 1 1 1 1 1 1 1 1 1 1 1 1 1 1 1 1 1 1 1